0 0 0 16 16 16 16 16 0 0 0 0
0 96 0 17 34 64 36 0 0 96 0 0
0 0 0 17 0 16 16 17 0 0 0 0
17 17 0 0 0 0 0 17 0 17 17 17
17 33 0 0 96 0 0 17 0 17 0 0
17 17 0 0 0 0 0 17 0 17 0 0
0 0 0 16 0 0 0 0 0 0 0 0
0 96 0 17 0 0 17 17 0 16 16 16
16 16 0 17 0 0 17 37 0 0 0 16
16 32 0 17 0 0 17 17 0 0 0 16
16 16 0 17 0 96 0 0 96 0 0 0
49 0 0 16 16 16 16 16 16 16 16 16


