0 0 49 17 17 17 17 17 17 17 17 17
0 0 16 0 0 0 0 0 0 0 0 0
0 0 16 0 96 17 0 0 0 16 0 0 
0 33 16 0 0 16 0 36 0 16 16 0
0 0 16 0 0 17 64 16 0 0 0 0
0 32 16 0 0 16 17 16 17 0 0 0
0 0 16 0 0 0 0 0 16 0 0 0
0 34 16 0 96 0 0 0 17 0 0 0
0 0 16 0 0 0 0 96 0 0 0 0
0 0 0 0 0 0 0 0 0 0 0 96
16 0 0 96 0 17 17 17 0 0 0 17
17 16 0 0 0 17 0 17 0 0 17 16
