16 0 0 0 96 16 0 0 0 96 0 18
16 0 0 17 0 16 0 0 0 96 96 0
16 0 32 17 0 16 0 16 16 16 16 16
16 17 17 17 0 16 0 17 0 0 32 0
0 0 0 0 0 36 0 17 0 33 0 0
17 16 16 16 0 35 0 17 16 16 16 96
17 0 0 17 0 16 0 0 96 0 0 0
17 0 34 17 0 16 0 0 0 96 0 0
17 96 0 17 0 16 0 0 0 17 17 17
17 0 0 17 0 16 0 0 0 16 36 0
17 0 0 0 0 0 0 0 0 16 0 0
0 0 0 0 17 17 17 17 0 0 0 0